25 11 40.0
#########################
#*.....................*#
#.#.#.#############.#.#.#
#.#.#.####-----####.#.#.#
#.....####-----####.....#
#.#.#.####     ####.#.#.#
#.#.#.####     ####.#.#.#
#.#.#.####     ####.#.#.#
#.#.#.#############.#.#.#
#*.....................*#
#########################
